####################
#  A ##      #######
#          @  o#####
#    @     #########
#        ###########
#    o           ###
####################