########
###    #
#      #
#  #   #
#  A   #
##o @   #
#      #
########
